#########
#.#.....#
#.#.#.#.#
#.#.#.#.#
#...#.#.#
#.##..#.#
#.#...#.#
#..##...#
#########