#######
#.#...#
#.#.#.#
#.#.#.#
#...#.#
#.##..#
#######