#######
#.#...#
#.#.#.#
#.#.#.#
#..##.#
#.#...#
#######